111111111111111
100011111000001
1C1000000010101
1111111100001C1
100000000011111
100100111110001
1001100000001C1
110101110101111
1EC10000C1000P1
111111111111111