111111111111111
1             1
1             1
1             1
1             1
1             1
1             1
1            11
1            P1
111111111111111