1111111111
1CC1000CC1
101101CC11
1000010001
1110011101
11100P0101
1111011001
1C010000C1
1C000110E1
1111111111