111111
1E1001
100101
111C01
1P0001
111111